10 10
SQUARES
G G G G G G G G G G
G G G G G W G G G G
G G G G G W G G G G
G G G G G W G G G G
G G G G G G G G G G
G G G G G G G G G G
G G G G G G G G G G
G G M M G G G G G G
G G G G G G G G G G
G G G G G G G G G G
BUILDINGS
2
C 1 1
C 10 10
UNITS
2
1 1
K 2 2
2 1
K 9 9
