10 10
SQUARES
G G G G G G G G G G
G G G G G W G G G G
G G G G G W G G G G
G G G G G W G G G G
G G G G G G G G G G
G G G G G G G G G G
G G G G G G G G G G
G G M M G G G G G G
G G G G G G G G G G
G G G G G G G G G G
BUILDINGS
4
C 1 1
C 10 10
M 10 1
M 1 10
UNITS
2
1 4
K 2 2
A 2 3
P 2 4
N 2 5
2 1
K 9 9
